aberrant(adjective): deviation
abstruse(adjective): difficult to understand; incomprehensible
ambivalent(adjective): mixed or conflicting emotions about something
anathema(noun): a detested person
apostate(noun): a person who has abandoned a religious faith or cause
arriviste(noun): a person who has recently reached a position of power; a social climber
bumbling(adjective): clumsy, lacking physical movement skills, especially with the hands
brazen(adjective): without shame
churlish(adjective): lacking manners or refinement
contingent(noun): small group
coterminous(adjective): being of equal extent or scope or duration
craven(adjective): pathetically cowardly
culpability(noun): a state of guilt
demure(adjective): to be modest and shy
derelict(adjective): (of a person) not doing one's duties
dissemble(verb): conceal one's true motives, usually through deceit
duress(noun): compulsory force or threat
embroiled(adjective): involved in argument or contention
espouse(verb): to adopt or support an idea or cause
finagle(verb): achieve something by means of trickery or devious methods
fortuitous(adjective): based on chance
fractious(adjective): irritable and is likely to cause disruption
frivolous(adjective): not serious in content or attitude or behavior
glib(adjective): insincere
glut(noun): an excessive supply
grovel(verb): show submission or fear
guileless(adjective): free of deceit
hector(verb): to bully or intimidate
heretic(noun): dissenter - a person who holds unorthodox opinions in any field (not merely religion)
incumbent(adjective): necessary (for someone) as a duty or responsibility
ineluctable(adjective): impossible to avoid or evade
litany(noun): any long and tedious account of something
parvenu(noun): upstart - a person who has suddenly become wealthy, but not socially accepted as part of a higher class
panache(noun): distinctive and stylish elegance
paucity(noun): a lack of something
provincial(adjective): characteristic of the a limited perspective; not fashionable or sophisticated
recrudesce(verb): relapse - to break out or happen again
macabre(adjective): suggesting the horror of death and decay; gruesome
maunder(verb): wander aimlessly
piquant(adjective): having an agreeably pungent taste
qualm(noun): uneasiness
quail(verb): draw back, as with fear or pain
saturnine(adjective): morose or gloomy
supplant(verb): take the place or move into the position of
sybarite(noun): a person who indulges in luxury
tenacious(adjective): stubbornly unyielding
turgid(adjective): (of language) pompous and tedious
untrammeled(adjective): not confined or limited
untoward(adjective): unfavorable; inconvenient
vindicate(verb): to clear of accusation, blame, suspicion, or doubt with supporting arguments or proof
