dilettante(noun): an amateur who engages in an activity without serious intentions and who pretends to have knowledge
staunch(adjective): firm and dependable especially in loyalty
exhort(verb): to strongly urge on; encourage
broadside(noun): a strong verbal attack
buck(verb): resist
graft(noun): corruption, usually through bribery
contrition(noun): the feeling of remorse or guilt that comes from doing something bad
prognostication(noun): a statement made about the future
gumption(noun): resourcefulness and determination
panegyric(noun): a formal expression of praise
umbrage(noun): a feeling of anger caused by being offended
hackneyed(adjective): lacking significance through having been overused
semblance(noun): an outward or token appearance or form that is deliberately misleading
objurgate(verb): express strong disapproval of
choleric(adjective): prone to outbursts of temper; easily angered
superfluous(adjective): serving no useful purpose
trenchant(adjective): characterized by or full of force and vigor; having keenness and forcefulness and penetration in thought, expression, or intellect
arrogate(verb): seize and control without authority
wanton(adjective): without check or limitation; showing no moral restraints to one's anger, desire, or appetites
ersatz(adjective): not real or genuine; phony
obdurate(adjective): stubbornly persistent in changing an opinion or action
gregarious(adjective): to be likely to socialize with others
Pollyannaish(adjective): extremely optimistic
cogent(adjective): clear and persuasive
flux(noun): a state of uncertainty about what should be done (usually following some important event)
vilify(verb): spread negative information about
temerity(noun): fearless daring
acerbic(adjective): harsh in tone
invective(noun): abusive or denunciatory language
pithy(adjective): concise andfull of meaning
plodding(adjective): (of movement) slow and laborious
internecine(adjective): (of conflict) within a group or organization
jejune(adjective): dull; lacking flavor
balk(verb): refuse to comply
lugubrious(adjective): excessively mournful
poignant(adjective): emotionally touching
hegemony(adjective): dominance over a certain area
tractable(adjective): readily reacting to suggestions and influences; easily managed (controlled or taught or molded)
checkered(adjective): one that is marked by disreputable happenings
errant(adjective): to be wandering; not sticking to a circumscribed path